111111111111111111111111111111
100P00000000000000000000000001
10000000C000000000C00000000001
100000000000000000000000000001
1000C00000000C0000000000000001
10000000000000000000C000000001
100000000C00000000000000000001
100000000000000000C00000000001
10000000C000000000C00000000001
100000000000000000000000000001
100000000000000000C00000000001
10000000C000000000C00000000001
100000000000000000000000000001
1000E00000000C0000000000000001
111111111111111111111111111111
