11111111
100eCCC1
1E0P0eC1
11111111
