1111111111111111
1PC00001000C0001
11000100000010E1
1111111111111111
