11111111
1000C1C1
1E0P0C11
11111111
