11111111
10000001
1E0P0001
11111111
