11111111
1000CCC1
1E0PcCC1
11111111
