11111111
1000CCP1
1E0P0CC1
11111111
