11111111
1E00CCC1
1E0P0CC1
11111111
