11111111
1000CCC1
1E0P0CC
11111111
