111111111111111111111
100010000010001000001
101110111011101011101
100010101010001010001
111010101010111010111
101010001010000010001
101011111010111111111
100010000000001010101
101110111110111010101
101000100010001000001
101011101011101011101
100000101010001000101
111110101010111111101
100010101010100000001
101110101010101011111
101000001010001000001
101011101011111111101
100010101000000010001
111010101111111110101
1PC0100010000000001E1
111111111111111111111
